#####I####
###    ###
#### ##  #
#        #
#####O####