##I#######
##     ###
#### ##  #
#     #  #
#####    #
#######O##